마법적 해석|Arcane Lexicon|고마법사|장면 동안 분발합니다. 한 장면 동안 암호화되지 않은 어떠한 글도 읽을 수 있습니다. 극도로 난해하거나 인간의 논리로 이해하기 힘든 글은 이해하지 못할 수 있습니다.
주문 무효화|Counter Magic|고마법사|보이는 마법사 적이 주문을 시전했을 때, 하루 동안 분발해서 즉시 행동으로 그 주문을 무효화시킬 수 있습니다. 당신이 지능/마법 혹은 매력/마법 기술 경쟁 굴림에 성공하면 주문이 사라집니다. 이 기교는 실질적인 주문시전자에게만 통하며 마법적 힘을 발동시키기만 하는 생명체들에게는 통하지 않습니다. 이 기교는 한 라운드에 한 번만 사용할 수 있습니다.
주문 강화|Empowered Sorcery|고마법사|즉시 행동으로 하루 동안 분발해서 피해량 등 주문의 효과와 관련된 주사위를 다시 굴립니다. 두 주사위 굴림 중 원하는 값을 선택할 수 있습니다.
주문 대기|Hang Sorcery|고마법사|주문을 시전할 때, 즉시 행동으로 장면 동안 분발합니다. 주문의 효과는 바로 일어나지 않고 간단 행동으로 나중에 다시 발동시킬 수 있습니다. 효과와 대상은 이때 정해집니다. 피해를 받았을 때 대기된 주문이 사라지지는 않지만, 대기 주문이 발동되거나 취소되기 전까지 새로운 주문을 시전할 수 없습니다.
피할 수 없는 결과|Inexorable Effect|고마법사|즉시 행동으로 하루 동안 분발합니다. 적이 내성 굴림에 성공했을 때, 다시 내성 굴림을 시도해 더 나쁜 결과를 택하게 합니다. 이 기교는 장면당 한 번씩만 사용할 수 있습니다.
강철의 의지|Iron Resolution|고마법사|전투에서 상처를 입었거나 집중할 수 없을 때 하루 동안 분발합니다. 육체 내성 굴림을 시도해 성공한다면 주문 방해를 물리치고, 그 라운드에 피해를 입었어도 주문을 시전할 수 있습니다.
준비된 주문 무효화|Preparatory Countermagic|고마법사|당신이 준비한 주문의 효과 범위 안에 있거나 주문 피해를 받았을 때 장면 동안 분발합니다. 당신은 주문의 직접적인 효과에 영향을 받지 않습니다.
정신력 변환|Psychic Conversion|고마법사|하루에 한 번 간단 행동으로, 주문 슬롯 하나를 소모하여 기관계 부하 1점을 제거합니다. 또한 레벨당 2점의 HP를 회복합니다.
조용한 시전|Restrained Casting|고마법사|고마법 주문을 시전할 때 즉시 행동으로 하루 동안 분발합니다. 피해를 입으면 시전을 방해받는 건 똑같지만, 동작과 소리 없이 그 주문을 시전할 수 있습니다. 
주문 회복|Retain Sorcery|고마법사|주문을 시전한 후에 간단 행동으로 하루 동안 분발합니다. 방금 시전한 주문은 하루의 주문 사용 횟수를 소모하지 않습니다. 이 기교는 하루에 한 번만 사용할 수 있으며, 당신의 다음 턴이 끝날 때 까지 다른 주문을 시전할 수 없게 합니다.
마법 감지|Sense Magic|고마법사|즉시 행동으로 분발합니다. 분발하는 동안, 당신은 마법적인 에너지를 눈으로 볼 수 있으며, 보고 있는 마법이나 마법 아이템에 대한 한 줄 설명을 들을 수 있습니다. 대부분의 장소에서 잔류하는 마법적인 기운 덕택에 완전하게 어두운 곳에서도 명확하게 볼 수 있습니다.
마법 억제|Suppress Magic|고마법사|100ft 이내에 있는, 보이거나 알려진 마법적 효과를 지정하며 간단 행동으로 하루동안 분발합니다. 마법적 효과는 신비를 근절하라(Extirpate Arcana) 주문의 효과와 같이 1d6 + 기교 사용자의 레벨 라운드동안 억제됩니다. 주문의 설명에 나와 있듯이 더 강력한 시전자가 시전한 주문은 억제하지 못할 수 있습니다. 효과를 억제하려는 시도는 한 번만 할 수 있습니다.
신속한 시전|Swift Casting|고마법사|장면 당 한 번 하루 동안 분발해서, 주요 행동을 필요로 하는 주문을 간단 행동으로 시전할 수 있습니다. 이 라운드에는 다른 주문을 시전할 수 없습니다. 이 라운드에 이미 주문을 시전했거나, 피해를 입었거나, 주문 시전이 어려운 상태일 때는 이 기교를 사용할 수 없습니다.
아군 방호|Ward Allies|고마법사|당신이 시전한 광역 주문 범위 안에 있는 최대 여섯의 아군에게 피해를 주지 않고, 직접적이고 부정적인 효과로부터 보호하기 위해 즉시 행동으로 하루 동안 분발합니다. 이것은 서 있는 건물의 파괴 등의 간접적인 결과로부터 보호할 수는 없습니다. 
마법사의 품위|Wizard's Grandeur|고마법사|단순 행동으로 분발합니다. 분발하는 동안에 상황에 상관없이 당신은 더러워지거나, 옷이 구겨지거나, 땀이나 얼룩이 생기지 않습니다. 더러운 물질들은 얼룩을 남기지 않고 당신으로부터 미끄러져 땅에 떨어지고, 일반적인 온도에서 의복에 상관 없이 편안하게 있을 수 있습니다. 당신은 51페이지의 룰과 상관없이 침대나 쉼터가 없어도 편하게 잘 수 있습니다.
원소 내성|Elemental Resilience|원소술사|당신은 비마법적인 평범한 혹한이나 화로보다 약한 열기에 면역이 됩니다. 마법적이거나 아주 강렬한 냉기 혹은 화염 공격에는 반의 피해를 입습니다.
원소 촉발|Elemental Sparks|원소술사|작은 양의 불꽃, 물, 얼음, 돌, 또는 바람을 만들어 냅니다. 이는 작은 트릭이나, 음료를 차갑게 하거나, 초에 불을 붙이거나, 다른 소소한 것들을 하기에 충분합니다. 생성된 물질은 한 장면 동안 지속되며 만들어 낸 물은 갈증을 해결할 수 없습니다. 이 기교로 문제나 난관을 해결하는 건 한 게임 세션당 한 번만 할 수 있습니다.
소환된 범람|Beckoned Deluge|원소술사|시전자 레벨 당 50ft 내로 보이는 지점에 거대한 물줄기를 생성하려면 주요 행동으로 장면 동안 분발합니다. 이 물의 양은 캐릭터 레벨 당 10 ft 정육면체를 채울 만큼의 질량을 만들기에 비마법적 다리를 쓸모없이 만들고, 화재를 진압하고, 초자연적 화염 생명체에게 시전자 레벨당 1d6의 피해를 줍니다. 생성된 물은 특별히 없어지지 않으며, 시전자 레벨당 10명에게 충분한 수분 공급을 할 수 있습니다.
대지 시야|Earthsight|원소술사|간단 행동으로 장면 동안 분발합니다. 남은 장면 동안, 당신은 완벽한 어둠 속에서도 단단한 물체들의 윤곽을 볼 수 있고, 레벨당 1 ft 두께의 흙이나 돌을 투시해서 볼 수 있습니다.
원소 방출|Elemental Blast|원소술사|캐릭터 레벨당 50ft 내의 보이는 대상에게 원소의 힘을 던지려면 주요 행동으로 장면 동안 분발합니다. 이 공격은 마법을 전투 기술로 적용하며 지능, 매력 혹은 민첩을 능력치로 사용하며, 캐릭터 레벨의 명중 보너스를 사용합니다. 근접한 적에게도 사용할 수 있습니다. 명중시, 이 공격은 1d6+레벨+사용한 수정치만큼의 피해를 줍니다. 불꽃의 투사체이거나 압축된 물의 격류를 뿜는 등의 경우에 부수적인 피해를 일으킬 수 있지만, 이 것으로 생성된 물질은 라운드가 끝날 때 사라집니다.
화염 시야|Flamesight|원소술사|간단 행동으로 분발합니다. 분발하는 동안 당신은 완벽한 어둠 속에서도 표면과 살아있는 생명체를 구분할 수 있는 온도차의 정도를 볼 수 있습니다. 추가적으로, 당신은 당신의 눈에서 주변 30ft를 밝히는 빛을 뿜어낼 수 있게 할 수 있습니다.
원소의 방벽|Pavis of Elements|원소술사|당신의 주변에 원소로 이루어진 방벽을 만들어내려면 간단 행동으로 분발합니다. 분발하는 동안 방벽이 유지되어 당신의 AC를 +4만큼 증가시킵니다. 이 AC 보너스는 다른 보너스들과 중첩될 수 있지만 AC를 18보다 높게 올릴 수는 없습니다.
석화의 응시|Petrifying Stare|원소술사|보이는 크리쳐를 대상으로 주요 행동으로 하루 동안 분발합니다. 해당 크리쳐는 육체 내성에 성공하지 않으면 부분적으로 석화되어 당신의 시전자 레벨의 절반의 반올림한 라운드 동안 이동 행동을 할 수 없게 됩니다. 비행하는 생명체는 이 기교로 착지할 수 밖에 없게 되며 헤엄치는 생명체는 바닥까지 잠기게 됩니다.
파괴의 룬|Rune of Destruction|원소술사|주요 행동으로 하루 동안 분발하여 근처의 단단한 표면을 지정합니다. 손바닥 크기의 빛나는 룬이 표면에 새겨져 시전자 레벨당 한 시간동안 지속됩니다. 룬으로부터 2ft 안에 크리쳐가 접근하면, 발동되어 당신이 선택한 원소의 힘으로 폭발해 5ft 반경 원 안에 2d6+당신의 캐스터 레벨의 피해를 입힙니다. 시전자는 룬을 발동시키지 않으며, 룬을 새겼을 때 5ft 범위 안에 있던 자들은 범위 안에 재진입했을 때만 발동시킵니다. 룬들은 서로의 효과 범위가 겹칠 수 없습니다.
허공 보행|Steps of Air|원소술사|간단 행동으로 장면 동안 분발하여 아군 하나를 지정합니다; 대상은 시전자 레벨당 1 라운드동안 자신의 이동 속도만큼 비행할 수 있습니다. 대상이 공중에 떠 있는 중에 기교가 끝나면, 대상은 피해 없이 땅에 착지하게 됩니다. 또한 이 기교는 떨어지고 있는 대상 하나의 낙하 피해를 없애기 위해 즉시 행동으로 사용될 수 있습니다. 
기절의 전격|Stunning Shock|원소술사|주요 행동으로 하루 동안 분발해서 캐릭터 레벨당 50ft 내의 보이는 크리쳐를 지정합니다. 대상 크리쳐는 1파운드 이상의 전도체 금속을 입거나 들고 있는 상태이거나 상당히 축축해져 있어야합니다. 번개가 시전자의 손에서 튀어나와 대상을 기절시켜 대상의 다음 주요 행동을 잃게 만듭니다. 대상이 육체 내성에 성공하면 효과를 경감시켜 주요 행동 대신 이동 행동만을 잃게 합니다. 한 크리쳐는 장면당 한 번만 이 것의 대상이 될 수 있습니다.
열에너지 방패|Thermal Shield|원소술사|눈에 보이는 아군이나 물체에게 가해지는 하나의 화염 혹은 냉기 피해를 즉시 없애려면 즉시 행동으로 장면 동안 분발합니다. 이 효과는 하나의 피해를 없앨 동안만 지속됩니다.
치료의 손길|Healing Touch|치료사|즉시 행동으로 장면 동안 분발합니다; 남은 장면 동안 당신은 주요 행동으로 아군에게 손을 대서 2d6 + 치료 기술만큼 회복시킬 수 있습니다. 이 치료는 대상에게 적용될 때 마다 1점의 기관계 부담을 줍니다.
강화된 치료사|Empowered Healer|치료사|당신의 치료의 손길(Healing Touch)는 더 강해져서, 그 치료량에 당신의 레벨을 더합니다.
손쉬운 치료사|Facile Healer|치료사|당신의 치료의 손길(Healing Touch)은 발전했습니다; 당신은 더 이상 이 능력의 사용에 분발을 할 필요가 없습니다.
원거리 치료사|Far Healer|치료사|당신의 치료의 손길(Healing Touch)은 더 좋아져서, 당신의 레벨당 10ft 밖의 보이는 대상에게 사용할 수 있습니다.
최후의 안정|Final Repose|치료사|보이고 살아있는 크리쳐를 대상으로 즉시 행동으로 하루 동안 분발합니다. 남은 장면 동안 대상은 당신의 치료 기술을 페널티로 받는 육체 내성 굴림을 굴립니다. 실패시, 대상이 이번 장면의 끝 이전에 HP가 0으로 떨어지면, 안정화나 부활의 가능성 없이 사망합니다.
치료사의 눈|Healer’s Eye|치료사|간단 행동으로 분발합니다; 분발하는 동안 당신은 주요 행동으로 시각적으로 독과 질병을 감지하고, 크리쳐들을 대상으로 진단을 정확하게 내리며, 대상의 생리를 이해할 수 있고, 현재 HP를 알 수 있습니다. 분발하는 것의 부작용으로 당신은 살아있는 크리쳐를 빛의 유무나, 시야를 흐리게 하는 안개의 유무에 상관없이 감지할 수 있습니다.
사지 복구|Limb Restoration|치료사|이 기교는 전문적인 치료사만 숙달할 수 있기에 8레벨 이전에 배울 수 없습니다. 당신은 대상에 접촉해서 없는 사지나, 장기 를 재생하고, 아주 큰 상처 혹은 다른 물리적인 병인을 제거하기 위하여 하루 동안 최소 1점을 사용해서 남아있는 모든 분발 점수로 분발합니다. 대상의 기관계 부담은 자동적으로 최대치가 됩니다.
질병 소거|Purge Ailment|치료사|주요 행동으로 하루 동안 분발합니다. 당신이 만지는 아군은 하나의 질병이나 독이 치료됩니다. 독으로 인해 죽은 크리쳐에게 죽은지 6분 내에 사용하면 부활합니다. 마법적인 독과 질병은 난이도 8 이상의 지혜/치료 혹은 매력/치료 판정이 필요할 수도 있습니다. 7 레벨이 되면 당신은 장면 동안만 분발해도 이 능력을 사용할 수 있습니다.
정교한 복구|Refined Restoration|치료사|당신과 당신이 자기전 돌봐준 최대 12명의 아군은 편안한 취침 후 1점이 아닌 2점의 기관계 부담을 회복합니다.
쓰러진 자의 부활|Revive the Fallen|치료사|이 기교는 전문적인 치료사만 숙달할 수 있기에 8레벨 이전에 배울 수 없습니다. 최근에 죽은 대상을 살리려고 주요 행동으로 분발해서 대상에게 접촉합니다. 이 능력은 시전자의 레벨당 1분 내에 죽은 대상으로 사용해야하며, 조각나거나, 불태워지거나, 어찌됐던 찢긴 시체에게 작동하지 않습니다. 대상의 기관계 부담은 자동적으로 최대화되며, 대상은 24시간 동안 의식을 잃은 상태로 있다가 1 HP와 함께 깨어납니다.
재빠른 치료사|Swift Healer|치료사|당신의 치료의 손길(Healing Touch)은 더 좋아져서, 캐릭터 레벨당 하루에 한 번 간단 행동으로 사용될 수 있습니다. 하지만 한 대상에게는 한 장면당 한 번밖에 사용을 못합니다.
치료사의 칼|The Healer’s Knife|치료사|당신의 치료의 손길(Healing Touch)은 변화해서, 살아있는 대상에게 치료뿐 아니라 피해를 주게 할 수도 있습니다. 피해량은 치료량과 같으며, 대상이 아닌 당신이 기관계 부담을 1점 얻습니다. 눈치채지 못한 대상에게는 단순히 닿는 것 만으로 사용이 가능하나, 근접 전투 중 이 능력의 사용은 당신의 치료 기술을 명중 보너스로 하는 성공적인 격투 공격이 필요하며, 피해량에 해당 공격의 피해도 추가됩니다. 당신의 치료의 손길(Healing Touch)을 바꾸는 기교는 이 기교에 적용되지 않습니다. 
지치지 않는 활력|Tireless Vigor|치료사|분발합니다; 분발하는 동안 당신의 먹고, 마시고, 숨쉬고, 자려는 욕구는 더 이상 커지지 않습니다. 당신은 지치지 않고 몸을 사용할 수 있으며, 매 시간당 잃은 HP를 1점 회복합니다.
생명력의 화로|Vital Furnace|치료사|당신의 엄청난 생명력은 당신이 입은 치명상이 아닌 모든 상처를 회복시킵니다. 당신의 HP를 0으로 만들지 않은 하나의 피해를 0으로 만들려면 즉시 행동으로 하루 동안 분발합니다. 별개로, 당신이 0 HP로 떨어지면 바로 안정화되며, 10분 뒤 1 HP로 일어납니다. 이 능력은 마법적인 교환이나 무언가의 힘을 사용해서 당신 스스로에게 일부러 가하는 피해에는 사용할 수 없습니다.
뼈와 대화하는 자|Bonetalker|사령술사|당신은 언어의 차이나 개체의 선천적인 투명화 상태와 상관 없이, 모든 언데드와 소통할 수 있고 볼 수 있습니다. 장면 동안 분발하면 당신은 사용하면 시야 내 언데드의 주어진 명령에 대한 인상 등의 표면적인 생각을 알 수 있습니다. 지능이 없는 언데드는 주인이 명령하거나 강제로 공격하게 되어 있지 않은 이상 당신과 동료들을 해치지 않습니다. 지능이 있는 언데드는 일반적으로 공격하기 전에 협상하기 위해 잠시 멈출 것입니다.
차가운 살점|Cold Flesh|사령술사|당신은 잠을 자지 않아도 되고, 고통을 추상적인 감각으로만 느끼게 됩니다. 당신은 모든 충격 피해를 2점까지만 입게 되고 12 + 당신의 레벨의 절반의 반내림을 기본 AC로 가지게 됩니다.
생명 에너지 흡수|Consume Life Energy|사령술사|최소 한 시간 축성한 격투 공격 혹은 근접 무기 공격으로 입힌 피해의 일부분을 흡수해 당신을 치료할 수 있습니다. 이렇게 축성한 것을 사용한 모든 성공적인 공격마다 당신은 당신의 피해량을 회복량의 상한치로 1d6의 히트포인트를 회복합니다. 당신은 공격한 대상의 남아있는 HP보다 더 많은 양을 흡수할 수 없습니다.
가짜 죽음|False Death|사령술사|즉시 행동으로 분발합니다. 분발하는 동안, 시전자는 일반적으로 조사했을 때 죽은 것으로 보입니다. '죽어있는' 동안 주요 행동을 잃지만, 평범하게 움직이고 주변을 지각할 수 있고 먹거나, 마시거나, 호흡하지 않아도 되며 그 외의 생리적 기능을 수행하지 않아도 됩니다. 당신의 레벨당 하루 동안 이런 죽은 상태를 유지할 수 있으며, 그 후 최소 한 시간 정도 회복을 해야합니다.
무덤 시야|Gravesight|사령술사|단순 행동으로 분발합니다. 분발하는 동안, 당신은 주변의 살아있는 생명체들의 생명 에너지를 주위의 비마법적 조명의 상태에 상관없이 형형색색의 빛으로 볼 수 있습니다. 당신은 시야로 질병, 독, 그리고 다른 신체적인 특성도 파악할 수 있습니다. 부수적인 효과로, 이 기교를 사용하는 동안 완벽한 어둠 속에서도 정상적으로 볼 수 있게 됩니다.
사문의 수호자|Keeper of the Gate|사령술사|당신이 원한다면 당신의 레벨 당 20ft내의 치명상을 입은 크리쳐들은 즉시 사망하고마법이나 의술로 살릴 수 없게 할 수 있습니다. 반대로, 당신은 하루 동안 분발해서 범위 안의 생명체들에게 1점의 기관계 부담을 주고 즉시 안정화시킬 수 있습니다.이 효과는 절단되었거나, 갈렸거나, 다른 살릴 수 없는 부상을 입은 크리쳐를 도울 수 없습니다.
생명력의 다리|Life Bridge|사령술사|당신은 동의하거나 무력화된 대상들끼리 생명력을 이전할 수 있습니다. 하루 동안 분발합니다; 남은 장면 동안 주요 행동으로 개보다 작지 않은 크기의 무력화되거나 동의하는 대상들에게 동시에 접촉해서 HP를 이전할 수 있습니다. 이 기교로 생명력의 기부자에게 치명상을 입힐 수 있지만, 수령인은 최대 HP 이상으로 생명력을 받을 수는 없습니다.
뼈의 주인|Master of Bones|사령술사|언데드는 당신의 능력이나 주문에 저항하는 내성 굴림을 해야 할 때, 두 번 굴려 나쁜 쪽을 택해야 합니다. 또한, 즉시 행동으로 장면 동안 분발해서 언데드가 당신을 대상으로 하는 공격, 마법적 능력이나 주문 하나를 무시할 수 있습니다. 당신의 레벨보다 2배 이상의 HD를 보유한 언데드에게 사용될 수 없습니다.
핏빛 수확|Red Harvest|사령술사|당신은 죽음에서 힘을 얻습니다. 50ft 내에서 1 HD 이상의 지능이 있는 생명체가 죽었을 때, 즉시 행동으로 하루 동안 분발하여 1d6 + 레벨만큼의 HP를 회복하거나 이 장면의 다음 명중 굴림에 +4 보너스를 얻을 수 있습니다. 이 기교는 중첩될 수 없고, 한 라운드에 한 번만 사용할 수 있습니다. 
불로|Unaging|사령술사|당신은 자연적으로 나이를 먹지 않고, 종족의 자연적 최대 수명 + 당신의 레벨의 20% 동안 건강하고 활력이 넘치게 됩니다. 그 뒤에는 먼지와 부패덩어리로 바뀝니다. 이 시점 이후의 불사를 손에 얻는 것도 가능하지만 지속적인 생명 에너지의 수급이나 심령술 재료, 다른 얻기 힘든 재료나 윤리적으로 의문성이 제기되는 재료가 필요합니다. 당신은 또한 독과 질병에 면역이 됩니다.
섬뜩한 체액|Uncanny Ichor|사령술사|당신의 피는 보통 존재의 피와 다릅니다. 포식자는 당신의 피에 구역감을 느끼고 위협받지 않는 이상 물지 않을 것입니다. 지능이 없는 포식자는 당신을 먹이로 생각하지 않을 것입니다. 이 체액은 몸에서 빼내기 어렵기 때문에, 찌르거나 꿰뚫린 상처로 치명상을 입는 것은 가능하지만, 바늘방석이 되거나 엄청난 물리적 피해를 입지 않는 이상 죽을 수는 없습니다.  
불생의 끈기|Unliving Persistence|사령술사|치명상을 입었을 때 자동적으로 안정화를 하려면 단순 행동으로 하루 동안 분발합니다. 손을 댈 수 있다면 이 기교를 다른 대상에게도 사용할 수 있습니다. 이 능력은 절단되었거나 명백하게 최종적인 죽음을 맞이한 대상에게는 사용할 수 없습니다.
무예|Martial Style|구도자|클래스와 무관하게 당신의 HD는 1d6보다 낮아질 수 없습니다. 격투 기술로 공격할 때, 당신의 클래스 명중 보너스는 같은 레벨의 전문가 명중 보너스보다 낮아질 수 없습니다. 3레벨부터, 격투 기술로 가해지는 모든 공격은 마법 무기 취급을 받습니다.
비무장 무력|Unarmed Might|구도자|레벨이 오를 때 마다 성장표에 적힌 대로 비무장 공격 피해가 증가합니다. 평소와 같이 이 피해에 격투 기술 레벨을 더할 수 있지만, 공수가(Unarmed Combatant)와 같이 당신의 격투 피해를 강화하는 포커스는 당신한테 적용되지 않습니다. 
맨몸 방어술|Unarmored Defense|구도자|당신이 갑옷이나 방패를 착용하고 있지 않을 때, 당신의 기본 AC는 13 + 당신 레벨의 절반의 반내림이 됩니다. 
사나운 반격|Brutal Counter|구도자|당신을 대상으로 한 적의 근접 공격의 판정이 명중하든, 그렇지 않든 끝난 후 즉시 행동으로 장면 동안 분발합니다. 당신은 당신의 공격자에게 일반적인 물리 공격을 하거나 주요 행동으로 할 수 있는 공격적인 능력을 할 수 있습니다. 이 기교는 라운드 당 하나의 적에게 한 번씩만 사용할 수 있으나 방어 태세 중에도 사용할 수 있습니다.
완벽한 지각|Faultless Awareness|구도자|당신의 뛰어난 지각능력은 당신을 기습에 면역으로 만들고, 깊은 수면 중에도 닥쳐오는 위험에 일반적으로 반응할 수 있게 일어납니다.
던져넘기기|Hurling Throw|구도자|당신이 공격을 명중시켰을 때, 즉시 행동으로 장면 동안 분발할 수 있습니다. 대상은 육체 내성 굴림을 하고, 실패시 당신이 원하는 방향으로 10ft만큼 내동댕이쳐져 넘어진 상태에서 당신이 명중시킨 공격의 피해를 입습니다. 육체 내성 굴림에 성공했다면, 대상은 공격의 피해만 입습니다. 이 기교는 라운드 당 적마다 한 번씩만 사용할 수 있으며, 대상은 물소보다 크면 안 됩니다.
내면의 눈|The Inward Eye|구도자|간단 행동으로 분발합니다. 분발하는 동안, 당신은 신비적으로 어둠, 안개, 실명, 혹은 감은 눈과 상관 없이 시각과 동일한 감각으로 주변을 볼 수 있게 됩니다. 
천상답보|Leap of the Heavens|구도자|장면동안 분발 하여 이동 행동으로 이동 속도만큼 수평으로 뛰거나 그 반만큼 수직으로 도약합니다. 또한 당신은 즉시 행동으로 장면 동안 분발해서 높이와 상관 없이 낙하 피해를 없앨 수 있습니다.
대가의 생명력|Master’s Vigor|구도자|당신의 신체는 자연적으로 수명이 다할 때 까지 젊은이의 체력과 활력을 유지합니다. 자연적인 재생력으로 인해, 매 시간마다 잃은 HP 2점을 회복합니다.
군중 정의|Mob Justice|구도자|즉시 행동으로 하루 동안 분발하여 한 장면동안 44페이지에 나와 있는 집단 공격 행동에 면역이 됩니다. 당신의 공격자는 이 전술을 남은 장면 동안 쓸 수 없으며 최소 두 명의 적과 근접 전투 중이면 충격 피해를 받지 않습니다. 하지만 격렬한 동작 때문에 이러한 효과에 있는 동안 당신은 주문 시전을 할 수 없습니다.
기민한 등반|Nimble Ascent|구도자|간단 행동으로 장면 동안 분발합니다. 남은 장면동안 마법이 부여되었거나, 유리 같이 매끄러운 표면이 아닌 이상 돌출되었거나 평평한 수직 표면을 오를 수 있고, 험한 지형을 미끄러지거나 넘어지는 일 없이 최대 이동 속도로 지나갈 수 있습니다. 당신은 벽이나 천장에 매달릴 때 한 손만 이용해서 매달릴 수 있습니다.
정화된 신체|Purified Body|구도자|당신에게 영향을 끼치는 질병이나, 독을 치료하거나 다음 24시간동안 수면, 허기, 갈증, 호흡에 대한 요구를 없애려면 즉시 행동으로 하루 동안 분발합니다.
부활의 호흡|Revivifying Breath|구도자|간단 행동으로 하루 동안 분발하여 1d6 + 당신의 레벨만큼의 HP를 회복합니다. 이 회복은 기관계 부담을 늘리지 않습니다. 이 능력은 HP가 0일 때도 당신의 턴에 사용할 수 있지만, 그렇게 한다면 남은 분발 점수를 전부 사용하게 됩니다.이 기교는 장면당 한 번만 사용할 수 있습니다. 
분쇄의 강타|Shattering Strike|구도자|하루 동안 분발하고, 한 라운드동안 몸을 미동하지 않고 준비합니다. 다음 라운드에 주요 행동으로 나무 문, 나무 벽, 혹은 비슷한 강도를 갖는 당신의 레벨당 1 ft 두께 물체에 사람 크기의 구멍을 뚫을 수 있습니다. 4레벨이 되면 이 능력으로 돌 벽을, 7레벨이 되면 이 능력으로 철벽이나 철문에 영향을 줄 수 있습니다. 이 공격은 움직일 수 있는 상대에게는 효과가 없지만, 움직일 수 없는 대상에게는 당신의 레벨당 1d12의 피해를 줍니다. 
유파 무기|Style Weaponry|구도자|검, 활, 도끼, 단검 등의 대략적인 무기 종류 세 가지를 선택합니다. 이 무기들을 사용할 때 명중 굴림에 접전이나 사격 대신 격투 기술을 쓸 수 있습니다. 격투 기술 레벨이 무기로 인한 공격의 피해에 추가되지는 않지만, 명중 굴림에 무예(Martial Style)의 이점들은 적용됩니다.
발견되지 않는 발걸음|Unobtrusive Step|구도자|당신은 상당한 변장과 위장 기술을 가지고 있을 뿐더러, 당신을 발견하는 것은 극도로 어렵게 됩니다. 장면당 한 번 즉시 행동으로 하루 동안 분발해서 실패한 잠행 기술 판정이나 누군가를 흉내내는 판정을 다시 굴릴 수 있습니다.
형상 변화|Change Form|변신술사|주요 행동으로 하루 동안 분발해서 다른 형상으로 변신합니다. 이 변신은 당신이 죽거나, 다른 형상으로 변하거나, 간단 행동으로 변신을 끝낼 때까지 유지됩니다. 당신의 HP, 기관계 부담, 그리고 다른 점수들은 바뀌지 않고 유지되지만, 비 인간의 형상에서는 클래스의 기본 공격 보너스가 표에 나와있는 것 보다 적을 수 없습니다. 만약 당신이 사족보행이라면, 이동 속도는 당신의 기본 속도보다 10ft 더 빠릅니다.
매의 눈|Eyes of the Hawk|변신술사|이 형상은 상당히 날카로운 감각을 갖고 있습니다. 당신은 개처럼 발자취, 혹은 물건의 냄새를 쫓을 수 있으며, 아주 희미한 소리를 듣거나, 수천 ft 밖에서도 얼굴을 파악할 수 있을 정도로 물건들을 명확하게 볼 수 있으며, 완전한 어둠만 아니라면 잘 볼 수 있습니다. 당신은 모든 감각적 감지 판정에 +2 보너스를 얻습니다.
고양이 도약|Feline Leap|변신술사|이 형상은 큰 거리를 도약할 수 있게 합니다. 당신은 이동 행동으로 당신의 이동 속도 만큼 도약을 할 수 있습니다. 수평으로 당신의 이동 속도만큼, 수직으로는 그 절반만큼 도약할 수 있습니다. 당신은 추락으로 인한 피해의 계산에서 당신의 이동 속도를 제외한 추락 거리를 계산해서 사용합니다.
흉포한 기량|Feral Prowess|변신술사|이 형상은 강화된 속도, 힘, 그리고 단단함이 있습니다. 힘, 민첩, 건강 중 하나를 선택하세요; 해당 능력 수정치는 최대 +2까지 +1 늘어납니다. 이 변신은 극단적으로 당연하게 보입니다; 당신이 이 기교를 쓰고 있다면 일반적인 인간의 행세를 할 수 없습니다. 건강 강화로 얻은 HP는 다시 변신하면 없어집니다.
내재된 갑옷|Intrinsic Armor|변신술사|이 형상에는 단단한 비늘, 가죽, 갑각 등 방어적인 외피가 있습니다. 당신의 기본 AC는 14 + 당신의 레벨의 절반의 내림입니다. 이 AC는 당신의 민첩 수정치, 그리고 방패를 들 수 있다면 방패를 듦으로 바뀔 수 있습니다. 
날개 구현|Manifest Wings|변신술사|이 형상에 사용할 수 있는 날개를 만들 수 있습니다. 공중에 떠 있는 것에 집중을 해야하기에 효과적으로 공격을 못하지만, 당신은 이동 행동으로 일반 이동 속도 +10’ 만큼 날 수 있습니다. 방해받지 않고 지역 이동을 한다면 시간당 10마일을 이동할 수 있고, 하루에 5시간 비행할 수 있습니다.
문어의 포옹|Octopus’ Embrace|변신술사|이 형상에는 사용할 수 있는 사지의 수가 4개를 넘어가게 됩니다. 이렇게 추가적인 촉수, 팔, 다리, 혹은 잡을 수 있는 손은 물건들을 쥐고 조작할 수 있습니다; 최대 4개까지의 보관된 물건들이 준비된 물건들의 하중 한계에 상관없이 준비될 수 있습니다. 이렇게 추가된 사지들로는 효과적인 방패 사용을 하지 못하고, 추가적인 공격이나 행동을 하지 못하며, 현재 행동에서 벗어나 큰 집중을 필요로 하는 것을 하지 못합니다.
완벽한 모방|Perfect Mimicry|변신술사|이 형상에는 대상의 머리카락 뭉텅이, 아직까지 액체 상태인 혈액 한 방울, 혹은 5ft 내에서 10분동안의 자세한 관찰이 필요하지만 해당 크리쳐로 완벽히 동일하게 변신할 수 있습니다. 한 번 이렇게 배운다면 추가적인 샘플이 필요하지 않습니다. 
유연한 살점|Pliant Flesh|변신술사|여전히 형상 변화 (Change Form) 행동을 한 라운드에 한 번밖에 쓰지 못하지만 당신은 변신 능력을 갈고 닦아 간단 행동으로 사용할 수 있거나, 1분 시간을 사용한다면 분발없이 사용할 수 있습니다.  당신이 분발해서 변신을 한다면 1d6 + 당신의 레벨만큼 잃은 HP를 회복합니다; 이 것은 단순히 변신한 상태에서 돌아올 때는 적용되지 않습니다. 이 기교는 당신에게 너무 선천적이기에, 형태에 적용가능한 최대 기교 갯수에 포함되지 않습니다.
야만스러운 발톱|Savage Talons|변신술사|이 형상은 굉장히 위험한 발톱, 앞니, 집게, 혹은 다른 신체 무기를 갖고 있습니다.  1레벨에 이 무기들은 1d8피해를 입히며, 힘 또는 민첩을 수정치로 사용하고, 격투를 전투 기술로 사용하며, 충격을 2/13로 갖습니다. 3레벨때 피해와 충격은 +1 늘어나며 6레벨때 +2가 되고, 9레벨 때 +3이 됩니다. 이 무기들은 비마법적 무기 피해에 면역인 크리쳐들에게도 피해를 줄 수  있습니다.
조각가의 아름다움|Sculptor’s Beauty|변신술사|당신은 정갈한 미적 감각을 발휘해서 당신을 보는 자들의 무의식적인 아름다움에 대한 선호에 호소할 수 있습니다. 이 형상은 당신의 매력 수정치를 +1로, 최대 +2까지 강화시킵니다. 이 아름다움에는 항상 무언가 이질적인 것이 섞여 있어서 일반적인 사람이나 동물로 인식되지는 않지만 이국적인 아인이나 개량 동물로 인식될 수 있습니다.
뱀의 입맞춤|Serpent’s Kiss|변신술사|이 형상은 손톱과 송곳니에 맹독이 스며나오게 할 수 있습니다. 공격이 명중하면 당신은 장면 동안 분발해서 즉시 행동으로 추가적인 1d8 + 생존 기술만큼의 추가적인 피해를 주게할 수 있습니다. 또한 당신은 이 독성을 치명적이게 하기 보다는 마비성으로 만들 수 있습니다; 이 공격으로 HP가 0이 된다면 대상은 치명상을 입기 보다는 한 시간 동안 아무것도 할 수 없는 마비 상태가 됩니다.
원숭이의 길|The Monkey’s Road|변신술사|이 형상에는 기어오르는 것에서 발휘되는 숲의 기민성이 있습니다. 당신이 사지를 3개 이상 사용할 수 있고, 표면이 유리처럼 매끄럽지 않다면 이상 당신의 이동 속도 만큼 수직 표면을 기어오를 수 있습니다. 당신이 떨어질 때 10ft 내에 매달릴 수 있는 표면이 있다면 당신은 피해없이 추락을 멈출 수 있습니다. 
전투형상|Warform|변신술사|당신은 이 형상에 있는 이상 모든 근접 공격에 +2 명중 보너스를 받고, 인간으로 있어도 형상 공격 보너스를 사용할 수 있게됩니다. 이 형상은 명백하게 전투적으로 보이며, 무해한 것이나 순수 인간으로 위장할 수 없습니다.
지느러미와 비늘의 지혜|Wisdom of Fin and Scale|변신술사|이 형상은 물 속에서 숨을 쉴 수 있게 하며 당신의 이동 속도의 2배만큼 수영 속도가 생기고, 일반적인 기후에서 극한의 추위나 바다의 수압에 영향을 받지 않게됩니다. 당신은 일반적인 빛이 없는 물 속에서도 60ft까지 볼 수 있습니다.
선호 무기|Favored Weapon|결투가|페이지 37에 나와있는 비무장 무기를 제외하고 하나를 선택하십시오. 당신은 그 무기를 들고 시작하고, 이 무기를 사용할때는 이미 무기 공격 보너스가 더 좋지 않은 이상 결투가 테이블의 선호 무기 공격 보너스 열의 값을 기본 명중 보너스로 사용할 수 있습니다. 당신의 두번째 부분 클래스가 부분 전사라면 당신의 기본 클래스의 공격 보너스는 당신의 레벨과 같습니다. 당신은 이것이나 다른 기교를 투척 무기에 적용할 수 없습니다.
피에는 피|Blood for Blood|결투가|적이 당신에게 물리적인 공격을 명중시키면 즉시 행동으로 장면 동안 분발합니다. 다음 라운드의 끝 이전에 당신이 이 적을 선호 무기로 공격하면, 처음 공격은 자동적으로 명중하고, 당신이 입은 피해보다 같거나 더 높은 피해를 줍니다. 이 피해량은 당신의 무기 피해의 최대 피해량을 넘을 수 없습니다.
폭발적인 속도|Burst of Speed|결투가|간단 행동으로 하루 동안 분발합니다. 당신은 간단 행동으로 당신의 이동 속도만큼 움직일 수 있습니다. 이 기교는 라운드당 한 번 사용 할 수 있습니다.
코드 듀엘로|Code Duello|결투가|하나의 적과 대결하는 도중 간단 행동으로 하루 동안 분발합니다. 다른 전투원이 당신 또는 당신의 적에게 공격을 하지 않고 당신도 이 적에게만 공격을 하는 이상,  당신은 AC에 +4 보너스를 받고, 명중 굴림을 두 번 굴려서 더 높은 값을 사용합니다. 코드 듀엘로(Code Duello)가 방해받거나 끝났다면, 남은 장면동안 다시 사용될 수 없습니다.
압도하는 우월성|Crushing Superiority|결투가|당신의 선호 무기는 저살상(less lethal)의 특성을 이미 갖고 있지 않는 이상 갖게 됩니다. 적에게 공격을 명중시키면 즉시 행동으로 장면 동안 분발합니다; 대상은 즉시 본능 판정을 진행합니다. 이 능력은 한 대상에게 장면당 한 번 사용할 수 있습니다.
겁 없는 발놀림|Dauntless Step|결투가|간단 행동으로 장면 동안 분발합니다. 남은 라운드의 끝에 당신의 무게를 버틸 수 있는 표면에 곧게 서있을 수 있는 이상 당신의 이동 행동은 수직 표면을 넘어가거나, 험지를 이동 속도의 저하 없이 넘어갈 수 있습니다.
파멸 피하기|Dodge Doom|결투가|당신이 폭발이나 다른 즉발성 효과에 휘말렸을 때 즉시 행동으로 하루 동안 분발합니다. 당신은 절반의 피해를 입거나, 내성 굴림을 굴릴 수 있는 상황에서 굴림에 성공한 경우 피해를 입지 않습니다. 당신은 폭발의 위치에서 멀어지거나, 엄폐물 안에 들어가기 위해서 처음 위치에서부터 10ft 이동할 수 있습니다.
강제 접전|Forced Engagement|결투가|당신의 선호 무기로 공격을 할 때 즉시 행동으로 장면 동안 분발합니다; 당신은 적의 아군 보호 행동을 이 공격으로 무시할 수 있습니다.
신사들의 철회|Gentlemen’s Withdrawal|결투가|이동 행동으로 장면 동안 분발합니다. 이 일환으로 당신은 적이 길을 아예 가로막지 않는 이상 무장된 적에 의해 방해받지 않고 최대 이동 속도로 움직일 수 있습니다. 당신은 상대하고 있는 적들에게 퇴각 행동을 한 것과 같은 효과를 얻습니다.
우아한 도약|Graceful Leap|결투가|간단 행동으로 장면 동안 분발해서, 수직이나 수평으로 10ft 도약을 하고, 퇴각 행동을 한 것과 같은 효과를 줍니다. 당신은 이 기교를 공격 이후에 사용할 수 없으며, 라운드당 한 번 쓸 수 있습니다. 당신은 30ft 이하로 떨어지는 경우 추락으로 인한 피해를 입지 않습니다.
번개 발도|Lightning Draw|결투가|적대적인 행동이 시작 될 때 즉시 행동으로 하루 동안 분발합니다. 당신은 먼저 행동할 수 있는 비슷한 능력을 갖고있는 자들 보다 우선권을 먼저 가져오고 보관된 선호 무기를 즉시 준비 상태로 만들 수 있습니다.
관통격|Piercing Strike|결투가|간단 행동으로 장면 동안 분발해서 보이는 대상을 지정합니다. 남은 장면 동안 대상의 AC는 당신의 선호 무기의 충격 저항 계산에 한하여 10으로 계산됩니다.
영체 무기|Spiritual Weapon|결투가|당신은 당신의 선호 무기를 원할 때마다 구현할 수 있는 영체 템플릿으로 만들 수 있습니다. 마법 무기를 포함한 어떤 선호 무기도 이러한 템플릿으로 만들 수 있지만 이 과정에서 물체의 물리적인 형태는 파괴됩니다. 템플릿을 구현하려면, 즉시 행동으로 분발합니다; 당신이 분발을 그만 두거나 무기를 만지고 있지 않을 때까지 무기의 영체 복제품이 손에 준비된 상태로 소환됩니다. 쌍수 무기 사용자는 이 기교로 같은 무기를 양 손에 소환할 수 있습니다.
묶이지 않는|Unbindable|결투가|사슬, 붙잡힘, 수갑, 새끼줄, 그리고 물리적으로 묶는 현상을 일으키는 주문을 탈출하고 싶을 때 간단 행동으로 하루 동안 분발합니다. 당신은 비마법적인 제압구에서 자동적으로 몸을 비틀어 빠져나오는 것에 성공하거나, 주문으로 인한 물리적 봉인에서 탈출하기 위한 회피 판정을 시도할 수 있습니다. 당신은 이 기교를 라운드당 한 번 쓸 수 있습니다.
약자멸시|Unworthy Rabble|결투가|간단 행동으로 하루 동안 분발합니다. 남은 장면 동안 선호 무기로 한 개의 HD를 지닌 적에 대한 공격이 명중하지 않을 경우, 다시 굴립니다. 8 레벨때 이 능력은 2개의 HD를 가진 적까지 적용됩니다.
휘감는 회피|Whirling Evasion|결투가|당신의 기본 AC는 13 + 당신의 레벨의 절반의 반올림이 됩니다. 이 AC는 작은 방패나 당신의 민첩 수정치에 따라 바뀔 수 있지만, 갑옷이나 큰 방패로는 바뀌지 않습니다.
동료 결속|Bind Companion|야수조련사|한 장소에서 하루 동안 노력하는 것으로 당신은 적합한 동물 동료를 찾아서 결속할 수 있습니다. 특정 종류의 동료를 찾고자 한다면, 이 지역에서 발견되어야 하며 특별히 희귀한 크리쳐라면 난이도 10 이상의 지혜/생존 판정이 필요할 수도 있습니다. 당신이 모험 중 적합한 크리쳐를 찾았다면 당신은 주요 행동으로 결속할 수 있습니다. 크리쳐는 저항을 하기 위해 정신 내성을 굴릴 수 있고, 성공시 당신의 힘에 면역이 됩니다. 당신이 동료가 필요 없다고 생각하거나, 다른 야수와 결속을 해야한다면, 주요 행동으로 동료를 결속으로부터 해방시킬 수 있습니다.
야수로부터의 보호|Beast Ward|야수조련사|간단 행동으로 분발합니다. 분발하는 동안 굶었거나, 주인에게 명령당하거나, 아군이 적대적인 행동을 하지 않은 이상 야수조련사는 지능적이지 않은 동물들에게 습격당하지 않습니다. 이러한 보호가 끝나거나 강제로 종료되면 이 장면에서 다시 사용할 수 없습니다. 마법적인 야수나 지역의 수호자로 특별히 훈련을 받은 경우 이 힘에 대해 정신 내성을 굴릴 수 있습니다.
야수의 눈|Eyes of the Beast|야수조련사|단순 행동으로 장면 동안 분발합니다. 남은 장면 동안 당신은 동물 동료와 감각을 공유할 수 있습니다. 둘 다 놀라지 않는 이상 당신은 놀라지 않습니다. 
사나운 억척|Feral Toughness|야수조련사|당신의 최대 HP 총합은 당신의 동물 동료의 자연적인 HD 수 만큼 늘어납니다; 그말인즉슨, 5 HD를 갖고 있는 동료는 당신의 최대 HP를 5점 올립니다. 당신은 일반적인 밖의 열기와 추위에 영향을 받지 않습니다. 당신의 기본 AC는 13 + 당신의 레벨의 절반의 반올림입니다. 이 AC는 방패나 민첩 수정치로 바뀔 수 있지만, 갑옷으로는 바뀌지 않습니다.
먼 곳에서 부르는 포효|Howl of Distant Summons|야수조련사|당신은 주요 행동으로 하루 동안 분발함으로 당신 옆으로 예전의 동물 동료를 소환 할 수 있습니다. 이 포효는 시공간을 넘어 퍼지기에, 당신의 전 동료는 포효 후 당신 옆으로 5분 내에 올 수 있는 곳에서 이 소리를 듣습니다. 당신이 현재 동물 동료가 없다면, 이렇게 소환된 동물과 다시 결속 할 수 있습니다. 여기로 오는 여정이 특별히 위험하고, 어렵고, 길다면, 당신은 난이도 10이나 그 이상으로 매력/생존 판정을 진행합니다; 실패시 야수는 이곳으로 오는데 실패하고, 다음 한 주간 이 힘으로 소환될 수 없습니다.
파악된 약점|Know the Weak Spot|야수조련사|야수에게 무기 혹은 물리적인 피해를 주는 경우, 피해 주사위를 두 번 굴려서 더 높은 숫자를 사용합니다. 혹은 소리를 들을 수 있는 거리의 아군이 야수에게 공격을 명중시켰을 때 즉시 행동으로 장면 동안 분발합니다; 당신이 소리친 조언이나, 방해로 해당 피해 주사위도 두 번 굴려서 더 높은 값을 사용합니다.
정신의 부름|Mind Call|야수조련사|간단 행동으로 장면 동안 분발합니다. 남은 장면 동안 당신은 당신의 동물 동료와 정신을 연결합니다. 당신은 동물 동료에게 명령을 내리거나, 제한된 지능을 갖고 있는 동물이 줄 수 있는 정보를 수신할 수 있습니다. 
자연의 무기|Natural Weaponry|야수조련사|당신은 물리적으로 이빨이나 발톱을 길렀을 수도 있고, 당신의 동물 동료를 보고 직감적으로 효과적인 격투술을 보고 배웠을 수도 있습니다. 당신의 비무장 공격은 힘 혹은 민첩을 사용하는 무기 취급을 받으며, 기술로 접전 혹은 격투를 사용하고, 1d8 피해를 입히며, 2/AC 13의 충격을 갖습니다. 이 비무장 공격은 비마법적 무기에 대한 면역을 갖고 있는 크리쳐들에게도 피해를 줄 수 있습니다. 이 무기들의 피해와 충격은 레벨 3때 +1 보너스를 얻고, 레벨 6때 +2, 레벨 9때 +3을 받습니다.
야만적인 감각|Savage Senses|야수조련사|간단 행동으로 장면 동안 분발합니다. 남은 장면 동안 당신은 완전한 어둠 속에서도 명확하게 볼 수 있으며, 마치 늑대처럼 발자취나, 소지품 등을 냄새로 파악할 수 있으며, 모든 시각, 청각, 후각에 관련한 감지 판정에 +2 보너스를 받습니다. 
공유된 생명력|Shared Vitality|야수조련사|당신과 결속한 동물은 더 적은 수의 HD를 갖고 있더라도 당신의 레벨만큼 HD를 갖게 됩니다. 7레벨 야수조련사에게 연결된 2 HD 동물 동료는 결속된 동안 7 HD를 갖고 있습니다. 명중 보너스는 HD의 절반의 반올림보다 낮을 수 없습니다. 야수조련사는 치명상이 입은 동물 동료를 장면 동안 즉시 행동으로 분발함으로서 안정화 시킬 수 있습니다. 
재빠른 치료|Swift Healing|야수조련사|주요 행동으로 하루 동안 분발해서 다친 동물 동료에게 캐릭터의 레벨당 1d6 피해를 회복시킵니다. 이 치료는 장면당 한 번, 혹은 15분당 한 번 할 수 있습니다. 
야수들의 혀|Tongue of the Beasts|야수조련사|간단 행동으로 분발합니다. 분발하는 동안, 당신은 털, 깃털, 비늘, 혹은 피부가 있는 생물과 대화할 수 있습니다. 이 기교는 그들이 순간적으로 인간 수준의 지능이 있는 듯 이야기를 할 수 있게 해주지만 그들의 흥미, 지식, 그리고 욕망이 바뀌지는 않습니다.
천개의 혀|A Thousand Tongues|사제|간단 행동으로 분발합니다; 분발하는 동안 당신은 스스로의 언어가 있는 지적 생명체와 대화를 나누고 이해할 수 있습니다. 당신은 대화를 당신의 언어로 하지만 듣는 사람한테는 해당 언어를 유창하게 하는 것으로 들립니다. 이 능력은 당신이 모르는 언어를 쓰고 읽게 해주지는 않습니다.
신의 갑주|Armor of God|사제|간단 행동으로 분발합니다. 분발하는 동안 당신의 자연적인 AC는 15 + 당신의 레벨의 절반의 반내림입니다. 이 AC는 방패나 당신의 민첩 수정치에따라 바뀔 수 있지만, 갑옷으로 바뀌지는 않습니다. 
신성한 인도|Divine Guidance|사제|당신의 앞에 주어진 행동이나 선택지에 대해 명상하면서 주요 행동으로 하루 동안 분발합니다. 그 행동으로 인한 결과가 좋을지(weal), 나쁠지(woe), 애매할지, 그리고 크게 중요하지 않을지에 대한 가장 타당한 결과를 GM이 최대한 알려줍니다. 이 통찰은 한 시간 이후의 미래에 대한 결과를 알려주지는 않습니다.
화염을 두려워 말라|Fear No Flame|사제|보이는 대상을 지정하면서 간단 행동으로 하루 동안 분발합니다. 남은 장면 동안, 대상은 비마법적인 화염, 연기, 폭발 피해에 대해 면역이며, 마법적인 화염들에 대해서는 당신의 기도 레벨당 5점의 피해를 경감합니다.  
신께서 뜻하신다|God Wills It|사제|큰 소리로 신의 축복을 당신의 아군에게 간청하면서 즉시 행동으로 하루 동안 분발합니다. 남은 장면 동안, 캐릭터 레벨당 6명의 아군은 실질적으로 12점의 사기를 얻고, 충격을 포함한 모든 명중 및 피해에 +1 보너스를 얻습니다. 5 레벨에 이것은 +2가 되고, 10레벨에는 +3이 됩니다.
자비로운 치료|Merciful Healing|사제|근접 거리 안에 있는 대상에 접촉하며 주요 행동으로 하루 동안 분발합니다. 대상은 1d6 +2 점의 마법적인 치료를 받습니다. 전투에서 사용되거나 치명상을 입은 대상을 부활시키면 대상은 치료의 급박함에 1점의 기관계 부담을 받지만, 전투외의 상황에서 사용되면 기관계 부담을 받지 않습니다. 4레벨에 치료량은 2d6+4로 증가하고, 8레벨에는 4d6+8이 됩니다. 
성스러운 방호|Sanctified Ward|사제|간단 행동으로 분발합니다. 분발하는 동안, 당신이 어떤 크리쳐에게 적대적인 행동을 하기 전까지 당신은 충격 피해에 면역이며 AC와 내성 굴림에 +4 보너스를 받습니다. 적들은 당신을 공격 할 때 매 라운드 본능 판정을 해야합니다; 실패시, 그들이 특별히 당신을 공격할 이유가 없다면 다른 행동을 합니다. 이 기교가 끝나면 다음 장면까지 다시 사용할 수 없습니다. 치료를 하거나, 싸우는 다른 동료들을 지원하는 것은 적대적인 행동으로 판정되지 않습니다. 
사악한 자들을 쳐부숴라|Smite the Wicked|사제|하나의 대상에게 공격을 하거나 피해를 입히려는 행동을 할 때 간단 행동으로 하루 동안 분발합니다. 당신은 명중 굴림에 +4 보너스를 받고, 당신의 캐릭터 레벨만큼 피해를 자동적으로 추가할 수 있으며, 모든 피해 주사위를 두 번 굴리고 더 높은 결과를 가져갈 수 있습니다. 이 능력은 장면당 한 대상에게만 사용할 수 있습니다.
신앙의 빛|The Light of Faith|사제|간단 행동으로 분발합니다. 분발하는 동안, 당신은 당신으로부터 30ft 밖까지 퍼지는 맑고, 밝은 빛을 뿜을 수 있습니다. 당신이 원한다면, 이 빛은 당신과 당신의 동료를 포함한 열댓 명의 아군에게만 보입니다. 
화체|Transubstantiation|사제|1갤런의 액체를 성수로 바꾸려면 주요 행동으로 하루 동안 분발합니다. 이 성스러운 액체 한 모금은 대상이 하루 동안 음식이나, 물 없이 보낼 수 있게 해주고, 잃어버린 HP를 1d6 + 시전자의 기도 레벨만큼 회복시켜줍니다. 1갤런의 성수는 대여섯명 정도에게 효과가 있습니다. 이 기교의 효과는 하루에 한 번 볼 수 있으며, 안마신 성수는 1분 내에 기화 되어 사라집니다.
거짓 생명의 퇴치|Turn False Life|사제|주요 행동으로 하루 동안 분발하여 60ft 내의 보이는 대상들을 상대로 신의 문양을 만듭니다. 2d6 + 당신의 캐릭터 레벨만큼의 HD 총합의 언데드, 오토마톤, 인공적, 타차원, 비자연적인 생물들은 정신 내성을 굴리고, 남은 장면, 혹은 동료들이 공격을 하기 전까지 두려움에 떱니다. 공포에 떠는 적들은 적대적인 행동을 하지 않고, 묶여있지 않는 이상 도망칠 것입니다. 이 힘은 사제의 레벨의 두 배이상 HD를 갖고 있는 존재에게는 통용되지 않습니다. 만약 굴린 HD 총합이 하나의 크리쳐를 완벽하게 넘지 못한다면 해당 크리쳐는 영향을 받지 않습니다. 
자비의 말|Words of Mercy|사제|평화를 유지하거나, 도움을 주거나, 자비, 진실, 그리고 박애 등 다양한 미덕의 행동을 권장하는 사회적 판정에 실패했을 때 즉시 행동으로 하루 동안 분발해서 다시 굴릴 수 있게 합니다. 이 기교는 한 기술 판정에 한 번만 사용될 수 있습니다. 
가장 높은 곳의 분노|Wrath of the Most High|사제|보이는 대상을 상대로 신벌을 내리려면 주요 행동으로 장면 동안 분발합니다. 다음 라운드의 끝 이전에 대상이 받는 첫 피해에 자동적으로 1d8 + 당신의 레벨만큼 피해가 추가됩니다.
정신 열람|Open Mind|생각 귀족|간단 행동으로 분발합니다. 분발하는 동안, 당신은 주요 행동으로 보이는 살아있는 크리쳐의 현재 감정적인 상태를 파악할 수 있습니다. 이 방법으로는 맥락상 당연하지 않은 이상 이러한 감정의 대상이 무엇인지를 파악할 수 없습니다.
기억 차단|Block Memory|생각 귀족|한 장면 이상 지속되지 않은 어떤 한 사건을 명시하며 보이는 살아있는 대상을 상대로 하루 동안 주요 행동으로 분발합니다. 대상은 정신 내성을 굴립니다; 실패시, 대상은 해당 사건을 잊고, 대신 일어날 법한 가짜 기억이 기억의 사이에 들어갑니다. 이 기억은 이 능력의 한 번 더 사용이나, 마법을 해제 할 수 있는 마법적인 능력으로 복구가 가능하지만, 기억이 바뀌었다는 것을 감지하는 것은 어렵습니다; 대상의 기억이 소거됐다는 것을 파악할 수 있는 능력의 기술 판정에 +2 난이도 페널티를 부과합니다. 
진실의 추출|Elicitation of Truth|생각 귀족|이 기교는 표층 감정(Surface Apprehension) 기교에 통달한 사람만이 배울 수 있습니다. 이 기교는 협조적이거나, 거부할 수 없는 상태의 대상에게만 사용할 수 있습니다; 생각 귀족은 하루 동안 분발해서 2 문장 이하로 할 수 있는 질문을 합니다. 대상이 정신 내성에 실패하면, 대상은 완전하고 진실되게 이 질문에 대답을 해야합니다. 대상은 개인적인 판단이나, 추측을 말할 필요는 없지만, 의식적으로 거짓말을 할 수 없고, 직설적으로 대답해야합니다. 
손쉬운 웅변|Facile Speech|생각 귀족|먼 웅변(Far Speech) 기교의 발전형으로, 당신은 대 여섯명의 동료들을 먼 웅변(Far Speech)의 선호 대상으로 선정할 수 있습니다. 당신은 이러한 선호 대상과 분발하지 않고 간단 행동으로 연결 할 수 있습니다. 선호 대상과의 연결 볌위는 생각 귀족 레벨당 1 마일입니다. 선호 대상을 변경하려면 변경하고자 하는 대상의 옆에서 약 한 시간 정도 명상을 하면 됩니다. 
먼 웅변|Far Speech|생각 귀족|간단 행동으로 장면 동안 분발해서 당신의 레벨 당 200ft 내에 있는 당신이 알고 있는 지적 생명체를 지정합니다. 대상이 동의한다면 당신은 생각, 말, 그리고 이미지를 공통된 언어 없이 전달할 수 있는 정신적 연결을 만듭니다. 연결은 남은 장면 동안 지속됩니다. 연결이 되어 있는 동안, 당신과 대상은 실패한 정신 내성 굴림을 다시 굴릴 수 있으며, 둘다 놀라지 않는 이상 놀라지 않습니다. 
초지각|Hypercognition|생각 귀족|당신은 당신의 정신에게 엄청난 수준의 계산, 예측, 기억을 수행하도록 할 수 있습니다. 당신은 사진과 같은 기억을 갖고 있으며, 머리 속으로 고등 연산을 할 수 있습니다. 즉시 행동으로 하루 동안 분발해서 실패한 지능 관련 기술 판정을 다시 굴릴 수 있습니다. 이 능력은 한 판정에 한 번만 사용할 수 있습니다.
심상 그림|Iconograph|생각 귀족|보이는 문헌, 조각상, 심볼, 혹은 보이는 다른 유물 등을 지정하며 주요 행동으로 장면 동안 분발합니다. 당신은 제작자가 해당 물건으로 전하고자한 아이디어나 메세지의 간략한 묘사를 들을 수 있습니다. 혹은, 당신은 이 기교를 문양, 예술품의 제작 및 글을 쓸 때 사용할 수 있습니다; 적합한 대상은 당신이 이것들을 통해 전하고자 한 메시지를 자동적으로 이해할 수 있습니다. 당신이 원한다면 당신의 메시지를 특정한 사람들만 알 수 있게 할 수 있습니다.
감동 명령|Impress Imperative|생각 귀족|보이는 대상에게 주요 행동으로 하루 동안 분발합니다. 당신은 대상의 성질이나 욕구에 반하는 행동이 아니라면, 대상에게 한 라운드 동안 무언가 하나의 행동을 하고 싶게 하는 강렬한 충동을 줍니다. 대상은 저항하기 위하여 정신 내성을 할 수 있지만, 실패시 다음 행동으로 강제된 행동을 해야합니다. 
심광|Mind Light|생각 귀족|당신의 정신 열람(Open Mind)은 강화되었습니다. 활성화 되어있는 동안, 당신은 당신 앞에 물리적 장벽이 있거나, 당신에게 능동적으로 숨으려고 하는 것이 아닌 60ft 내의 살아있는 모든 정신들을 파악할 수 있습니다. 당신이 이러한 종족들을 이미 알고 있는 경우 이러한 정신들의 종족을 알 수 있으며, 강한 감정적 상태도 알 수 있습니다. 당신이 알고 있는 개인들도 구별이 가능합니다. 정신 열람이 활성화되는 동안 당신은 살아있는 크리쳐에 의해 놀라지 않습니다.
육체 위의 정신|Mind Over Matter|생각 귀족|당신의 물리적인 현상에 대한 당신의 정신적 지배는 상당합니다. 즉시 행동으로 하루 동안 분발하여 다음 중 하나의 효과를 받습니다: 치명상을 입었을 때 자동적으로 안정화, 24시간동안 잠을 안자도 됨, 입은 피해량 중 1d6을 회복, 하루 동안 일반적인 추위와 더위의 극한 무시. 이와 비슷한 육체적인 상태의 조절은 GM이 허락 할 수 있습니다. 
거울 가면|Mirror Mask|생각 귀족|당신에게 향해진 정신에 영향을 끼치는 힘에 대해서 즉각적으로 알게되고, 당신의 현 감각 범위안에 있다면 누가 근원인지 파악할 수 있습니다. 당신에게 정신 내성 굴림을 굴리게 하는 효과일 경우 내성 굴림을 다시할 수 있습니다; 정신 내성 굴림을 굴리게 하지 않는 효과에 대해서도 한 번의 정신 내성을 굴릴 수 있는 기회가 주어집니다. 당신이 만약 성공한다면 즉시 행동으로 하루 동안 분발해서 해당 효과에게 당신이 주고 싶은 가짜 정보를 주거나 성공을 했다고 착각하게 할 수 있습니다. 
긍정 연관|Positive Association|생각 귀족|주요 행동으로 하루 동안 분발해서 보이는 지능적 크리쳐를 지정합니다. 대상은 정신 내성 굴림으로 저항 할 수 있습니다; 실패시, 당신과 당신의 행동은 무해한 행복과 존경의 반짝거림과 합쳐집니다. 당신 혹은 당신의 동료가 대상을 공격하거나, 대상이 사랑하는 것에 대해 해를 끼치거나, 대상 근처를 한 시간 이상 벗어나지 않는 이상 대상은 당신을 존경하는 친구로 생각하며, 당신의 행동은 항상 이성적이고 현명하다고 판단합니다. 나쁘게 이용되지 않은 크리쳐들은 이 힘이 끝날 때 믿을 이유가 제공되지 않는 이상 자신이 어떤 마법에 걸렸다고 생각하지는 않습니다. 이 능력은 한 번에 하나의 대상에게만 영향을 끼칠 수 있습니다. 
의도 파악|Read Intent|생각 귀족|즉시 행동으로, 보이고 살아있는 크리쳐를 대상으로 장면 동안 분발합니다. 대상은 저항을 하기 위한 정신 내성을 굴릴 수 있습니다; 실패시, GM은 이 크리쳐가 다음 턴에 할 행동을 알려주고, 전투가 아닌 상황에서 사용되면 다음하고자 하는 관련있는 행동을 알려줍니다. 당신이 이번 라운드 완전 방어(Total Defense) 행동을 했다면 대상의 움직임에 대한 직관으로 남은 라운드 동안 대상이 할 수 있는 모든 공격을 다 피할 수 있습니다.  
표층 감정|Surface Apprehension|생각 귀족|보이고 살아있는 크리쳐를 대상으로 주요 행동으로 장면 동안 분발 합니다. 대상이 정신 내성에 실패하면, 남은 라운드 동안 대상의 즉각적인 표층 생각을 알 수 있습니다. 당신이 대상에게 특정 질문을 하면 본능적으로 답에 대한 생각을 할 것이지만, 표층 생각은 한 두 문장으로 제한됩니다.
면도날 같은 생각|Thoughts Like Razors|생각 귀족|주요 행동으로 하루 동안 분발하여 보이고 살아있는 60ft 내의 크리쳐를 대상으로 정신적 타격을 가합니다. 대상은 저항을 위한 정신 내성을 굴립니다; 실패시 1d8 + 당신의 레벨 만큼 피해를 입습니다. 이 피해는 대상을 기절시킬 수 있지만 죽일 수는 없습니다. 성공시, 생각 귀족은 피드백을 받아 기절해서 피해량의 ¼의 반내림 한 값을 피해로 입고 다음 라운드의 행동을 잃습니다. 이 능력은 장면당 한 번 쓸 수 있습니다. 
생각할 수 없는 생각|Unthinkable Thought|생각 귀족|보이고 살아있는 크리쳐를 대상으로 대상의 주위에 있는 특정한 사람, 물건, 혹은 상황을 지정하며 주요 행동으로 하루 동안 분발합니다. 대상은 저항을 위해 정신 내성을 굴릴 수 있습니다; 실패시, 지정된 것이 목숨을 위협하는 것이 아니라면 지정된 것의 존재를 의식적으로 파악할 수 없습니다. 이런 강제된 무지는 한 장면 동안 지속됩니다; 장면의 끝에 대상은 지정된 것에 대한 기억이 없습니다.
저주받은 검|Accursed Blade|저주받은 자|간단행동으로 손에 심령술의 힘이 담긴 근접무기를 1d8 한손 무기, 혹은 2d6 양손 무기로 투영합니다. 둘 다 당신의 마법 기술을 피해량에 더하며, 2/15 충격을 갖고, 마법 + (힘, 민첩, 지력, 매력 중 제일 높은 수정치)를 공격 굴림에 추가합니다.
저주받은 화살|Accursed Bolt|저주받은 자|저주받은 검처럼 사용되며, 심령술의 힘을 가까운 거리에 휘두르는 것이 아니라 발사합니다. 피해량은 1d8 + 마법이며, 사정거리는 200 ft, 그리고 근접 거리로는 -4 페널티를 받으며 던질 수 있습니다. 이 화살들은 양손이 비어 있어야 던질 수 있습니다.
홀리는 방해|Bewitching Distraction|저주받은 자|전투 중이 아닌 지능이 있는 대상에 대해 주요 행동으로 하루 동안 분발합니다. 대상은 정신 내성을 굴리며, 실패시 이번 한 장면동안 몽롱함에 빠져서 주변에 일어나는 일들을 파악하지 못하고 당신과 그 장면에서 일어났던 일들을 잊어버립니다. 위험은 이러한 몽롱함을 멈추지만, 잊는 것을 막지는 못합니다.
강제하는 비명|Compelling Shriek|저주받은 자|장면당 한 번, 주요 행동으로 하루 동안 분발해서 최대 7개까지의 단어를 포함한 명령을 소리칩니다. 지정된 대상들 중 이 말을 듣고 이해한 대상들은 정신 내성을 굴리고, 실패시 그들의 특성에 대해 너무 반대되는 것이 아닌 이상 그들은 명령이 된 행동을 한 라운드 동안 실행합니다.
악마와의 거래|Devil’s Bargain|저주받은 자|다른 사람과 강요되지 않은 거래를 할 때 주요 행동으로 축성을 합니다. 거래 대상이 거래를 깨거나, 거래의 뜻에 반하는 행동을 할 경우 당신은 바로 알 수 있으며, 원한다면 대상에게 레벨 당 1d6의 피해를 줄 수 있습니다.
끔찍한 계약|Dire Pact|저주받은 자|적들은 당신의 저주받은 자의 기교에 대항하는 모든 판정에 당신의 마법 기술 만큼의 페널티를 받습니다. 그들이 만약 성공한다면 당신은 1의 기관계 부담을 얻습니다.
거짓말하는 얼굴|Lying Face|저주받은 자|주요 행동으로 분발합니다. 분발하는 동안 당신은 대략적으로 크기가 비슷하고, 옷, 냄새, 목소리가 다른 인간형으로 변장할 수 있습니다.
밤처럼 검은 눈|Night Black Eyes|저주받은 자|당신은 완벽한 어둠속에서도 명확하게 볼 수 있습니다. 주요 행동으로 보이는 특정한 물건, 사람, 혹은 장소에 집중을 하면 그것에 마법이 부여됐는지 알 수 있습니다. 마법에 대한 세부적인 특징은 알 수 없습니다.
계약된 보호|Pacted Protection|저주받은 자|해로운 에너지 중 한 종류를 고르십시오: 화염, 냉기, 산성, 전기 등등. 당신은 해당 에너지의 자연적인 정도의 양에 대해 면역이며, 해당 에너지와 연관된 마법적인 공격에 대해서는 절반의 피해를 받습니다.
생명력 탈취|Rob Vitality|저주받은 자|장면당 한 번, 보이는 적을 대상으로 간단 행동으로 장면 동안 분발합니다. 대상은 육체 내성을 굴리고 실패시, 다음 번 주요 행동을 잃게 되며 그 즉시 당신에게 생깁니다.
재앙의 저주|Scourging Curse|저주받은 자|주요 행동으로 장면 동안 분발해서 보이는 적을 지정합니다. 당신의 저주는 대상의 명중, 피해, 그리고 모든 내성굴림에 -1의 페널티를 레벨당 1 라운드 동안  부과합니다. 4레벨에 이 페널티는 -2가 되고 9레벨에는 -3이 됩니다. 이 저주는 어느 시점에서든 한 개만 활성화됩니다.
그늘진 발자국|Shadowed Steps|저주받은 자|이동 행동으로 장면 동안 분발해서 당신의 이동 거리까지 순간이동을 할 수 있습니다. 당신은 벽이나 물리적인 장애물을 통과할 수는 없지만 수직으로 순간이동하거나 높은 곳으로 이동할 수 있습니다.
속박의 말|Snaring Speech|저주받은 자|라운드당 한 번, 다른 사람을 설득하거나 유혹하려는 판정에 실패한 경우, 즉시 행동으로 하루 동안 분발합니다. 대상은 정신 내성을 굴리고, 실패시 당신의 제안이 그들이 일반적으로 할법한 행동일 경우 동의합니다. 이 기교를 사용할 때 1 점의 기관계 부담을 받습니다.
마법전지|Sorcerous Battery|저주받은 자|하루당 한 번, 간단 행동으로 하루 동안 분발합니다. 당신, 혹은 당신이 볼 수 있는 아군은 이전 라운드의 시작 이후 시전된 주문의 주문 슬롯을 회복합니다. 1점의 기관계 부담을 받습니다.
영혼 포식|Soul Consumption|저주받은 자|당신이 저주받은 화살(Accursed Bolt) 혹은 저주받은 검(Accursed Blade)으로 지능이 있는 대상을 쓰러뜨리면 즉시 행동으로 하루 동안 분발합니다. 대상은 바로 사망하며 당신은 1d6 + 당신의 레벨 만큼 HP를 회복하며 누적된 기관계 부담 1점을 잃습니다.
밤의 덩굴손|Tendrils of the Night|저주받은 자|간단 행동으로 분발합니다. 분발하는 동안 당신의 주위로 당신의 힘 만큼 물체들을 조작할 수 있는 20ft 길이의 촉수 여러 개, 또는 기이한 팔들이 여럿 돋아납니다. 다른 추가적인 행동을 얻지는 못하지만, 이 팔들로 장거리에서 근접전을 할 수 있습니다. 이 팔들은 당신의 AC를 가지고 있고 피해를 입으면 당신이 피해를 입습니다.
보이지 않는 발걸음|Unseen Steps|저주받은 자|간단 행동으로 하루 동안 분발해서 당신의 레벨 + 1d6 라운드만큼 투명해집니다. 이 투명 상태는 당신이 공격을 하거나, 주문을 시전하거나, 다른 격렬하고 폭력적인 행동을 하기 전에 사라집니다.
죄악의 무게|Weight of Sin|저주받은 자|주요 행동으로 하루 동안 분발해서 보이는 적을 지정합니다. 대상은 육체 내성을 굴리고 실패시, 1d6+ 당신의 레벨만큼의 라운드동안 이동 행동을 잃습니다.
우는 상처|Weeping Wounds|저주받은 자|라운드당 한 번, 보이는 적이 피해를 입으면 즉시 행동으로 장면 동안 분발합니다. 대상은 육체 내성을 굴리고 실패시 당신의 레벨만큼의 라운드 동안 라운드마다 1d6 피해를 받습니다. 대상은 이 효과에 영향을 받는 도중 회복하거나 재생을 할 수 없습니다. 이 기교는 중첩되지 않습니다.
천개의 혓바닥|A Thousand Tongues|음유시인|의사소통이 필요한 당신의 기교는 언어에 상관없이 직감적으로 모든 지적 생명체들이 이해합니다. 당신은 원어민과 일주일 정도만 같이 공부를 해도 새로운 언어를 배울 수 있습니다.
전투의 함성|Battle Cry|음유시인|간단 행동으로 하루 동안 분발해서 아군들을 진작시킵니다. 그들은 레벨당 1라운드만큼 명중, 내성굴림, 충격을 포함한 피해량에 +1을 받습니다. 4 레벨에 이 보너스는 +2가 되고, 9레벨에 +3이 됩니다.
저주의 음율|Cursed Tune|음유시인|지적 생명체를 대상으로 주요 행동으로 장면 동안 분발합니다. 당신의 비난은 그들을 망설이게 해서 레벨 당 1라운드만큼 명중, 내성굴림, 충격을 포함한 피해량에 -1을 받습니다.4 레벨에  -2가 되고, 9레벨에 -3이 됩니다.
민첩한 손가락|Deft Fingers|음유시인|당신은 악기를 쥐고있는 동안 소지품들을 다루는데 익숙해졌습니다. 당신의 최대 준비된 물건의 숫자가 2 늘어납니다.
주창 엉킴|Entangle Incantation|음유시인|60’ 이내의 적이 주문을 시전하면 즉시 행동으로 장면동안 분발합니다. 당신의 목소리는 그들의 말과 엉켜 대상의 지능/마법 대 당신의 매력/공연 +2의 대항 판정을 합니다. 당신이 비기거나 이긴다면, 주문은 사라지며 낭비됩니다. 이 기교는 라운드당 한 번 사용할 수 있습니다.
감정 자아내기|Evoke Emotion|음유시인|주요 행동으로 공연 도중 하루 동안 분발합니다. 당신은 동물이든, 지적 생명체든 청중에게 원하는 감정을 자아내 장면동안 관련있는 사회적 판정에 +1 보너스를 장면동안 당신과 당신의 아군들에게 부여합니다. 원한다면 새로운 반응 판정을 강제해서 처음 값보다 좋다면 그 값을 가져가도 됩니다. 이 기교는 전투 중에 사용할 수 없으며, 장면 당 한 번 사용할 수 있습니다.
절망감 선사|Inspire Dread|음유시인|적이 사기 판정을 굴려야만 할 때 즉시 행동으로 하루동안 분발합니다. 당신은 그들의 공포를 자극하여 하나 대신 두 번의 사기 판정을 진행하게 합니다. 두개 다 성공하더라도 즉시 본능 판정을 굴려야 합니다.
날카로운 감각|Keen Senses|음유시인|맹인 음악가 대가들이 처음 시작한 이 기교는 눈이 멀었더라도 60’ 밖 까지의 시야를 제공합니다. 당신은 색깔을 구분하지는 못하지만, 마치 눈으로 보듯 물리적 세부 사항을 알 수 있습니다. 물리적으로 투명한 크리쳐나 물건들은 당신에겐 당연하게 보입니다.
해방의 노래|Liberating Song|음유시인|당신은 정신 혹은 감정을 조종하는 효과에 대해 면역입니다. 당신의 아군이 이러한 효과에 대해 내성굴림을 굴릴 경우, 당신은 즉시 행동으로 장면 동안 분발하여 범위 내의 아군에게 정신 내성굴림을 한 번 더 굴리게 할 수 있습니다. 두번째 내성굴림에도 실패할 경우, 이 기교는 그들을 더 이상 도와줄 수는 없습니다.
결집|Rally|음유시인|상처를 입거나 쓰러진 아군을 일으켜 쇠약 상태를 제거하려면 주요 행동으로 하루 동안 분발합니다. 대상은 2d6 + 당신의 레벨 만큼 HP를 회복하지만 당신은 1점의 기관계 부담을 얻습니다.
야만성을 달래다|Soothe the Savage|음유시인|주요 행동으로 하루 동안 분발합니다. 당신이 각 라운드 동안 주요 행동으로 공연을 하는 동안, 동물과 다른 살아있는 야수 크리쳐들은 주인에 의해 명령되거나, 파티에게 위협당하지 않는 이상 당신과 당신의 아군들을 공격하지 않습니다. 이 기교는 전투가 시작되면 효과를 얻을 수 없습니다.
편안한 우아함|Soothing Graces|음유시인|당신의 기교는 당신과 함께한 자들을 회복시키고 희망을 복돋습니다. 당신과 당신의 동료들은 편안한 휴식을 지내는 밤마다 추가적으로 1점의 기관계 부담을 제거합니다. 이 능력은 비슷한 휴식을 도와주는 효과와 중첩되지 않습니다.
재빠른 오인|Swift Misdirection|음유시인|목소리를 들을 수 있는 범위 내의 지적 생명체를 대상으로 주요 행동으로 장면 동안 분발합니다. 그들에게 한 문장 이하로 무언가를 말합니다; 당신이 말한 것이 물리적으로 불가능하거나, 감정적으로 버틸 수 있는 것이 아닌 이상 대상은 정신 내성을 굴리고, 실패시 한 라운드 동안 그 말을 믿습니다. 이후 대상은 당신의 말에 정상적으로 판단할 수 있습니다. 이 기교는 장면당 크리쳐에게 한 번 효과를 일으킬 수 있습니다.
절대적 무효화|Absolute Negation|항마사|원하지 않는 주문이나 주문으로 인해 지속되는 효과에 의해 제한되거나 영향을 받으려고 할때 즉시 행동으로 분발합니다. 당신은 해당 효과를 무시할 수 있습니다.
항마도|Antimage|항마사|당신은 무화사(Nullifier) 포커스의 레벨을 하나 얻습니다. 어째서인지 무화사의 레벨이 2라면, 다른 포커스를 하나 얻습니다.
마법 일소|Dispel Enchantment|항마사|주요 행동으로 아군을 만지면서 하루 동안 분발합니다. 당신의 손길은 신비를 근절하라 (Extirpate Arcana) 주문과 동일합니다. 이 기교는 크리쳐에게만 사용 가능하고 물건에는 사용할 수 없으며, 하루당 한 번 자신 혹은 주어진 대상에게 사용할 수 있습니다.
주술 방해|Disrupt Sorcery|항마사|간단 행동으로 장면동안 분발합니다. 해당 라운드 동안 당신의 다음 공격의 대상은 남은 라운드동안 주문을 시전하거나 마법사 클래스의 기교를 사용하지 못합니다. 이 효과는 공격이 명중하지 않더라도 발생하며, 이미 활성화 되어 있는 기교는 취소되지 않습니다. 해당 공격이 아군 보호로 보호 받았다면, 대상은 효과를 받지 않습니다.
흠없는 육체|Immaculate Body|항마사|마법적인 변신, 저주, 혹은 잔여 마법으로 인한 페널티는 당신에게 최대 한 장면 동안만 적용됩니다. 이러한 해악은 당신을 죽일 수 없으며, 최악의 경우에도 1 HP로 떨어뜨립니다. 이러한 효과는 적대적인 주문뿐 아니라 모든 마법적인 효과에 적용됩니다.
흠없는 정신|Immaculate Mind|항마사|마음에 영향을 끼치거나 마음을 읽는 주문에 대해 당신은 원한다면 면역이며, 자동적으로 환영이나 마법적인 투명함을 꿰뚫어 봅니다. 이 능력은 주문뿐 아니라 모든 마법적 효과에 적용됩니다.
사냥감을 알라|Know Your Prey|항마사|당신의 마법 기술은 최대 4레벨까지 1레벨  높은 것으로 취급됩니다. 이 효과는 당신의 분발 점수에 더해지며, 당신의 캐릭터 레벨이 제한하는 레벨보다 더 높은 마법 기술 레벨을 보유하게 해줍니다.
마법살|Magebane|항마사|당신이 시전자에게 가하는 무기 피해, 충격 피해, 폭력적인 행동 등으로 인한 피해에 당신의 레벨의 절반을 반올림한 값을 추가합니다.  이 능력은 전사 클래스의 치명적인 공격(Killing Blow) 능력과 중첩되지 않습니다.
고통을 공유해라|Share the Pain|항마사|당신이 적대적인 주문의 대상이 되거나 그 범위 안에 있을때 즉시 행동으로 하루 동안 분발합니다. 정신 내성굴림을 굴립니다; 성공시, 주문의 시전자 또한 당신을 노린 주문의 효과를 받는 것으로 취급합니다. 이 기교는 라운드당 한 번 사용될 수 있습니다.
주문방패|Spellshield|항마사|주문이 당신에게 HP 피해를 입힐 경우, 저항이나 내성이 반영되기 전 자동적으로 피해량을 절반의 반내림한 값을 사용합니다.
아군 방호|Ward Ally|항마사|30ft 내의 아군이 주문의 대상이 되었을 때 즉시 행동으로 장면 동안 분발합니다; 아군 대신 당신이 주문 효과의 대상이 됩니다. 당신이 이미 효과의 범위 안에 있다면 주문은 당신에게 두 번 적용됩니다. 이렇게 전이되는 효과에 당신의 방어나 기교를 적용시킬 수 있습니다.
마녀탐색자|Witchfinder|항마사|주요 행동으로 장면동안 분발합니다. 남은 장면 동안, 당신은 암시야 효과를 제외한 비전 형태의 감정 (Apprehending the Arcane Form) 주문의 효과를 받습니다.
공포와 경외|Dread Awe|현인|[일반 기교]당신과 같은 사람들은 공포와 불신을 일으킵니다. 협박 및 겁에 질리게 하는 모든 기술 판정에 +1 보너스를 받습니다. 당신은 주요 행동을 사용하여 당신의 적에게 전투 도중 저주를 퍼부을 수 있습니다; 이 저주를 듣는 자들은 다음 사기 판정에 -1 페널티를 받습니다. 당신은 이 것을 장면당 한 번 할 수 있습니다.
연줄|Elite Ties|현인|[일반 기교]당신은 사회적으로 중요한 자와 연줄이 있습니다. 당신은 별 다른 노력없이 그들과 접견을 할 수 있습니다. 게임 세션당 한 번,  그들은 큰 불편이 없는 작은 부탁을 들어줍니다.
학식|Erudite|현인|[일반 기교]당신은 흔하지 않게 배운 사람입니다. 하루에 한 번, 지식의 탐구와 관련이 있거나 학자가 알 만한 것과 관련된 판정에 실패하면, 다시 굴릴 수 있습니다.
민중의 친구|Folk-Friend|현인|[일반 기교]평민 혹은 하층민 주민들은 당신을 도움이 되는 치료사나 도움을 주는 분으로 생각합니다. 하루에 한 번 당신을 싫어하지 않는 평민으로부터 조언이나 축복을 대가로 작은 친절을 받을 수 있습니다.
치유사|Healer|현인|[일반 기교]당신은 훈련받고 유능한 치유사입니다. 모든 치료 관련 판정에 +1 보너스를 받습니다; 하루에 한 번, 간단 행동으로 치명상을 입은 대상을 안정화 시키는 기술 판정에 성공합니다.
신성한 존엄성|Holy Sanctity|현인|[일반 기교]당신은 이 지역의 대부분에게 존경받고 공경받고 있습니다. 당신의 사회적, 종교적 소속에 대해 처음부터 반감을 갖지 않은 지역주민을 대상으로 하는 모든 사회적 판정에 +1 보너스를 받습니다.
개인적 비처벌성|Personal Impunity|현인|[일반 기교]당신은 신성성의 증표를 갖고 있고, 당신을 물리적으로 해하는 것은 이 지역에서 타부로 여겨집니다. 가장 사납고 절박한 사람들만 당신에게 폭력성을 휘두를 것이지만 먼저 공격을 당한다면 누구든 맞서 싸울 것입니다. 먼저 도발되지 않는 이상 당신을 적대하는 자들은 당신의 동료들을 공격하는데 주저할 것입니다.
숙련된|Skilled|현인|[일반 기교]비전투 기술에만 사용할 수 있는 기술 포인트를 3점 얻습니다. 여전히 기술의 최대 레벨은 당신의 레벨에 따라 정해집니다. 이 기교는 여러번 선택될 수 있습니다.
진실 강제|Compel Truth|현인|[예지 기교]술자는 다른 다른 사람에게 강제로 어떤 물약을 마시게 하거나, 특정 의식에 참가하게 하거나, 아니면 장면 동안 지속되는 어떤 과정에 포함시킵니다. 이후, 술자는 대상에게 하나의 질문을 하고 GM은 몰래 매력/마법 판정을 대상의 사기+1의 난이도나 PC일 경우 레벨 +6의 난이도로 진행합니다.  성공일 경우 대상은 질문에 대해 진실되게 전부 말합니다. 실패시 대상은 원하는 대로 말할 수 있습니다. 이 기교로 같은 질문을 두 번 이상 물어볼 수 없습니다.
신탁 예언|Deliver Oracle|현인|[예지 기교]간청자가 어떤 행동들의 결과 대해 물어봅니다. 술자는 이후 신탁을 받기 위해 하루 정도 소요되는 다양한 의식을 진행합니다. 의식의 끝에 GM은 몰래 지혜/마법 판정을 굴립니다. 판정이 난이도 8보다 높으면 어느 정도의 진실이 담긴 신탁 한 문장을 얻습니다. 판정이 난이도 12보다 높으면 직접적이고 당연한 신탁이 만들어집니다. 판정이 7이하라면, 절망적으로 모호한 신탁이 만들어지고, 판정의 주사위 굴림이 자연적 2가 나오면 명백하게 잘못된 신탁이 만들어집니다. 이런 신탁은 은유, 시, 혹은 어떤 보이는 장면으로 전달됩니다. GM은 이 신탁 중 특정 부분이 실제로 일어나도록 해야합니다.
물건 탐색|Find Object|현인|[예지 기교]술자는 장면 동안 특정한 동물, 물건, 혹은 금, 물, 특정 훔쳐진 소 등의 물체를 찾기 위한 의식을 진행합니다. 사람은 이 기교로 찾을 수 없습니다. GM은 몰래 지혜/마법 판정을 물체가 가까운 정도에 따른 난이도 8~11사이로 진행합니다; 같은 마을에 있는 것이라면 8, 1 마일 내외는 11이며, 5마일 밖에 있는 것은 감지가 불가능 합니다. 판정이 성공적이면, 술자는 물체가 어느 방향에 있는지에 대한 대략적인 인상을 받습니다. 실패시 1d12를 굴려서 시침이 가리키는 방향을 지칭하듯, 무작위 방향을 알려줍니다. 이 기교는 하루에 한 번 사용할 수 있습니다.
징조 읽기|Read Omens|현인|[예지 기교]간청자가 어떤 행동을 할지에 대해 PC에게 말합니다. 10 실버 이상되는 가축이나 공물을 사용해서 한 장면 정도 되는 길이의 의식을 끝마치면, GM은 몰래 난이도 10에 대항하여 지혜/마법 판정을 굴립니다. 성공시, PC는 GM이 생각하기에 타당한 실패, 혹은 성공의 결과에 대한 인상을 듣습니다. 실패시 GM은 무작위의 결과를 알려줍니다.  의식에 소요되는 공물의 가격을 10배로 늘리면 기술 판정에 +1 보너스를 받습니다; 예를들어 1,000 실버 가격 정도의 가축을 공물로 바치면 +2 보너스를 받습니다. 어떤 특정한 행동의 결과는 한달에 한 번 밖에 예지가 안됩니다.
상서로움|Auspicious Undertaking|현인|[저주와 축복]주요 행동으로 대상이 준비하거나 진행하려고 하는 일을 축복합니다. 계획의 실행이나 대상이 목표로한 결과를 얻는 도중 축복받은 대상은 실패한 기술 판정이나, 빚맞은 명중 굴림을 다시 굴릴 수 있습니다. 이 축복은 사용되거나, 계획이 종결되거나, 시전자 레벨당 일 수만큼 지나면 사라집니다. 한 시점에서 오직 하나의 계획만 축복받을 수 있습니다.
사안|Evil Eye|현인|[저주와 축복]이 기교는 당신의 저주와 축복 기교들을 강화합니다. 당신은 이러한 기교들을 즉시 행동으로 쓸 수 있지만 여전히 라운드당 한 번만 사용할 수 있습니다. 당신은 특정한 저주나 축복을 부여할 때 무언가를 읊는 대신 대상을 쳐다보기만 해도 됩니다.
불행|Ill Fate|현인|[저주와 축복]주요 행동으로 보이는 대상을 저주합니다. 특정한 행동을 지정하거나, 대상이 할 수 있는 것들을 선택합니다. 대상이 진행하는 바로 다음 기술 판정은 -1 페널티를 받습니다. 대상의 주사위 값이 PC의 마법 기술 +1 보다 작다면 대상의 행동에 대참사가 일어납니다. 저주는 다음 관련있는 기술 판정까지 유지됩니다.
행운|Luck Blessing|현인|[저주와 축복]주요 행동으로 보이는 대상에게 축복을 내립니다. 하루 내 대상이 시도하는 기술 판정에 +1 보너스를 받습니다. 어떤 시점에서든 크리쳐당 단 하나의 행운의 축복만 적용됩니다.
전쟁|War Curse|현인|[저주와 축복]주요 행동으로 보이는 적을 저주합니다.  대상은 남은 장면 동안 명중 굴림, 피해 굴림, 그리고 충격 피해에 -2 페널티를 받습니다.  만약 대상의 명중 굴림 주사위 값이 현인의 마법 기술 보다 낮다면 그들은 실수로 자신을 때려 일반적인 피해량의 피해를 받습니다. 단 하나의 전쟁의 저주만 활성화 됩니다.